###########
#S    #   #
# ## # # ##
#  # # #  #
# ## # ## #
#    A    #
#### #####E
###########
